2 2 2 2 2 2 2 2 2 2 2 2 2 2 2 2 2 2 2 2
4 1 2 2 2 2 2 2 2 1 1 1 1 1 1 1 1 2 2 2
4 1 1 1 1 1 1 1 1 1 1 1 1 1 1 1 1 1 2 2
4 1 1 1 1 1 1 1 1 1 1 1 1 1 1 1 1 1 2 2
4 1 1 1 1 1 1 1 1 1 1 1 2 2 1 1 1 1 2 2
2 2 2 2 1 1 1 1 1 1 1 2 2 2 1 1 1 1 2 2
2 2 2 2 2 2 2 2 2 2 2 2 2 1 1 1 1 1 2 2
2 2 2 2 2 2 2 2 2 2 1 1 1 1 1 1 2 2 2 2
2 2 2 2 2 2 2 2 2 2 1 1 1 1 1 1 2 2 2 2
2 2 2 2 2 2 2 2 2 2 1 1 1 1 1 1 1 1 1 2
2 2 2 2 2 2 2 2 2 2 1 1 1 1 1 1 1 1 1 2
2 1 1 1 1 4 1 1 2 2 2 1 1 1 1 1 1 1 1 2
2 1 1 1 1 4 1 1 1 2 2 2 2 2 2 2 1 1 1 2
2 1 1 1 1 4 1 1 1 1 2 2 2 2 2 2 1 1 1 2
2 1 1 1 2 2 1 1 1 1 1 2 2 2 2 1 1 1 1 2
2 1 1 1 2 2 2 1 1 1 1 1 1 1 1 1 1 1 1 2
2 1 1 1 2 2 2 1 1 1 1 1 1 1 1 1 1 1 1 2
2 1 1 1 1 2 2 2 1 1 1 1 1 1 1 1 1 1 2 2
2 1 1 1 1 2 2 2 1 1 1 1 1 1 2 2 2 2 2 2
2 3 3 3 8 2 2 2 2 2 2 2 2 2 2 2 2 2 2 2
