2 2 2 2 2 2 2 2 2 2 2 2 2 2 2 2 2 2 2 2
2 2 2 2 2 1 1 1 1 1 1 1 1 2 2 2 2 2 2 2
2 2 2 2 1 1 1 1 1 1 1 1 1 1 1 2 2 2 2 2
2 2 2 1 1 1 1 1 1 1 1 1 1 1 1 2 2 2 2 2
2 2 2 1 1 1 1 1 1 1 1 1 1 1 1 1 1 1 2 2
2 2 1 1 1 1 1 1 1 1 2 2 1 1 1 1 1 1 2 2
2 2 1 1 1 1 1 1 1 1 2 2 2 1 1 1 1 1 2 2
2 2 2 1 1 1 1 1 1 1 2 2 2 1 1 1 1 1 2 2
2 2 2 4 4 4 4 4 4 2 2 2 2 2 1 1 1 1 2 2
2 2 2 2 1 1 1 1 1 2 2 2 2 2 1 1 1 1 2 2
2 2 2 2 2 1 1 1 1 2 2 2 2 2 1 1 1 1 2 2
2 2 2 2 2 1 1 1 2 2 2 2 2 2 1 1 1 1 2 2
2 2 2 2 2 1 1 1 2 2 2 2 2 2 4 4 4 4 2 2
2 2 2 2 2 1 1 1 2 2 2 2 2 2 2 2 2 2 2 2
2 2 2 2 2 4 4 4 4 2 2 2 2 2 2 2 2 2 2 2
2 2 2 2 2 1 1 1 1 2 2 2 2 2 2 2 2 2 2 2
2 2 2 2 2 2 1 1 1 2 2 2 2 2 2 2 2 2 2 2
2 2 2 2 2 2 1 1 1 1 2 2 2 2 2 2 2 2 2 2
2 2 2 2 2 2 1 1 1 1 2 2 2 2 2 2 2 2 2 2
2 2 2 2 2 2 3 3 8 3 2 2 2 2 2 2 2 2 2 2
